事故处理	城乡建设
安全生产管理	城乡建设
安全隐患	城乡建设
园林绿化环卫	城乡建设
城管执法	城乡建设
居民服务设施	城乡建设
城市公共设施	城乡建设
公共汽车	城乡建设
公园管理	城乡建设
冬季采暖	城乡建设
园林绿化	城乡建设
地铁城铁	城乡建设
基础设施	城乡建设
小区管理	城乡建设
燃气供应	城乡建设
环境卫生	城乡建设
电力供应	城乡建设
自来水供应	城乡建设
规划方案	城乡建设
违章建筑	城乡建设
容积挡光	城乡建设
其他	城乡建设
历史名城保护	城乡建设
规划设计	城乡建设
其他	城乡建设
新农村建设	城乡建设
小城镇建设	城乡建设
施工安全	城乡建设
其他	城乡建设
抗震防灾	城乡建设
房屋拆迁	城乡建设
审批手续	城乡建设
城镇危房改造	城乡建设
其他	城乡建设
安置补偿	城乡建设
回迁房	城乡建设
棚户区和城中村改造	城乡建设
回迁房	城乡建设
房屋拆迁	城乡建设
其他	城乡建设
安置补偿	城乡建设
棚户区和城中村改造	城乡建设
工程招投标	城乡建设
勘察设计和施工监管	城乡建设
其他	城乡建设
拖欠工程款	城乡建设
企业资质和执业资格	城乡建设
其他	城乡建设
住房公积金	城乡建设
保障性住房	城乡建设
物业服务	城乡建设
其他	城乡建设
产权交易	城乡建设
房地产开发管理	城乡建设
住房困难	城乡建设
修缮装修	城乡建设
公房	城乡建设
房产证登记、办理	城乡建设
房屋租赁	城乡建设
房屋补贴	城乡建设
房屋评估	城乡建设
房改政策	城乡建设
私房	城乡建设
骗购	城乡建设
制度建设	党务政务
组织建设	党务政务
作风建设	党务政务
其他	党务政务
廉政建设	党务政务
其他	党务政务
侨务	党务政务
港澳事务	党务政务
台湾事务	党务政务
外交外事	党务政务
其他	党务政务
军事国防	党务政务
宗教事务	党务政务
民族政策	党务政务
民族事务	党务政务
其他	党务政务
其他	党务政务
工会工作	党务政务
共青团工作	党务政务
妇联工作	党务政务
其他	党务政务
互联网信息监管	党务政务
其他	党务政务
精神文明建设	党务政务
广播影视管理	党务政务
出版管理	党务政务
新闻管理	党务政务
其他	党务政务
统战工作	党务政务
政治体制改革	党务政务
政协工作	党务政务
人大工作	党务政务
气象	国土资源
海洋	国土资源
地震	国土资源
其他	国土资源
矿山地质环境	国土资源
矿产开采	国土资源
其他	国土资源
地质勘查	国土资源
其他	国土资源
安置补偿	国土资源
审批手续	国土资源
土地占地	国土资源
其他	国土资源
失地农民保障	国土资源
耕地保护	国土资源
土地规划	国土资源
其他	国土资源
土地转让	国土资源
土地权属纠纷	国土资源
生态示范和模范城区创建	环境保护
环境监测	环境保护
环境资质管理	环境保护
环境执法	环境保护
淘汰落后产能补偿	环境保护
污染损害纠纷调解	环境保护
其他	环境保护
专项资金使用	环境保护
生态破坏	环境保护
危险化学品污染	环境保护
噪音污染	环境保护
放射性污染	环境保护
固体污染	环境保护
大气污染	环境保护
其他污染	环境保护
其他	环境保护
电磁污染	环境保护
水污染	环境保护
土壤污染	环境保护
未验先用	环境保护
环评报告不实	环境保护
未批先建	环境保护
其他	环境保护
其他	环境保护
党纪处分	纪检监察
其他	纪检监察
政纪处分	纪检监察
官僚主义	纪检监察
其他	纪检监察
形式主义	纪检监察
奢靡之风	纪检监察
享乐主义	纪检监察
其他	纪检监察
打击报复	纪检监察
以权谋私	纪检监察
其他	纪检监察
其他	纪检监察
包庇纵容	纪检监察
玩忽职守	纪检监察
买官卖官	纪检监察
挪用公款	纪检监察
贪污	纪检监察
行贿受贿索贿	纪检监察
其他	纪检监察
财产来源不明	纪检监察
经营权转让	交通运输
运价监管	交通运输
其他	交通运输
网约车问题	交通运输
行业监管	交通运输
运营权管理	交通运输
其他	交通运输
规费征稽	交通运输
规划建设	交通运输
设施维护	交通运输
公路收费	交通运输
出租车管理	交通运输
货物运输	交通运输
物流管理	交通运输
其他	交通运输
旅客运输	交通运输
运输安全	交通运输
其他	交通运输
其他	交通运输
邮政市场监管	交通运输
邮政行业规划	交通运输
快递市场管理	交通运输
安全生产管理	经济管理
事故处理	经济管理
其他	经济管理
安全隐患	经济管理
期货基金	经济管理
保险业监管	经济管理
证券业监管	经济管理
其他	经济管理
资产流失	经济管理
企业兼并重组	经济管理
企业改制	经济管理
其他	经济管理
经济体制改革	经济管理
区域发展	经济管理
收入分配	经济管理
其他	经济管理
产业行业政策	经济管理
其他	经济管理
集资融资	经济管理
税收征管	经济管理
财政收支	经济管理
金融管理	经济管理
非法经济活动	经济管理
新能源产品研发与推广	经济管理
节能降耗	经济管理
其他	经济管理
能源开发供应	经济管理
其他	经济管理
其他	经济管理
政策性破产	经济管理
依法破产	经济管理
其他	科技与信息产业
通信保障	科技与信息产业
运营商监管	科技与信息产业
电信资费	科技与信息产业
成果鉴定转化	科技与信息产业
发展规划	科技与信息产业
其他	科技与信息产业
其他	科技与信息产业
信息产业发展规划	科技与信息产业
软件行业管理	科技与信息产业
其他	科技与信息产业
互联网运营管理	科技与信息产业
其他	科技与信息产业
知识产权保护	科技与信息产业
知识产权申报	科技与信息产业
其他	民政
福利事业	民政
慈善捐助	民政
复员干部安置	民政
转业退伍安置	民政
其他	民政
军休安置	民政
社区建设	民政
村委会选举	民政
居委会选举	民政
其他	民政
救灾管理	民政
其他	民政
捐赠服务	民政
社团登记	民政
社团管理	民政
其他	民政
其他	民政
其他	民政
区划调整	民政
边界纠纷	民政
地名管理	民政
收养登记	民政
婚姻登记	民政
殡葬管理	民政
生活无着人员救助	民政
其他	民政
其他	民政
农村低保	民政
城镇低保	民政
医疗救助	民政
特困人员供养	民政
其他	民政
老退役军人待遇	民政
评残及伤残抚恤	民政
参试退役人员待遇	民政
参战退役人员待遇	民政
生活住房医疗	民政
退牧还草	农村农业
破坏草原	农村农业
其他	农村农业
征占草场	农村农业
其他	农村农业
集体资产管理	农村农业
村级债务	农村农业
集体财务公开	农村农业
村务公开	农村农业
扑杀补偿	农村农业
其他	农村农业
疫情防控	农村农业
其他	农村农业
扶贫开发资金使用管理	农村农业
扶贫开发政策	农村农业
其他补贴	农村农业
其他	农村农业
农机农资补贴	农村农业
粮食直补	农村农业
良种补贴	农村农业
退耕还林	农村农业
水土流失	农村农业
森林防火	农村农业
国有林业资产管理	农村农业
其他	农村农业
采伐运输	农村农业
林权改革及权属纠纷	农村农业
其他	农村农业
价格质量	农村农业
运输购销	农村农业
粮食储备	农村农业
职工待遇	农村农业
其他	农村农业
经营管理	农村农业
其他	农村农业
农资价格质量	农村农业
农技推广应用	农村农业
其他	农村农业
农村“八大员”问题	农村农业
其他	农村农业
移民补偿安置	农村农业
后期扶持	农村农业
工程建设管理	农村农业
其他	农村农业
引水调水	农村农业
规划设计	农村农业
水事纠纷	农村农业
防汛抗旱	农村农业
江河湖治理	农村农业
其他	农村农业
宅基地纠纷	农村农业
土地承包	农村农业
土地流转	农村农业
野生动植物保护	农村农业
其他野生资源管理	农村农业
其他	农村农业
其他	商贸旅游
景区管理	商贸旅游
旅游市场管理	商贸旅游
其他	商贸旅游
劳务输出	商贸旅游
贸易发展战略	商贸旅游
其他	商贸旅游
进出口管理	商贸旅游
市场垄断	商贸旅游
反倾销	商贸旅游
商标管理	商贸旅游
不正当竞争	商贸旅游
商品质量	商贸旅游
其他	商贸旅游
广告监管	商贸旅游
中介机构管理	商贸旅游
传销	商贸旅游
物价监督	商贸旅游
直销	商贸旅游
其他	商贸旅游
特种设备管理	商贸旅游
产品质量监控	商贸旅游
认证认可标准化	商贸旅游
出入境检验检疫	商贸旅游
检验检疫	商贸旅游
突发公共卫生事件处理	卫生计生
其他	卫生计生
疾病预防控制	卫生计生
其他	卫生计生
计生执法	卫生计生
计划生育服务管理	卫生计生
失独家庭	卫生计生
违法生育	卫生计生
人口政策	卫生计生
独生子女父母奖励政策	卫生计生
其他	卫生计生
食品安全	卫生计生
药品和医疗器械管理	卫生计生
保健品化妆品管理	卫生计生
其他	卫生计生
患者权益	卫生计生
医护人员权益	卫生计生
医疗事故争议	卫生计生
其他	卫生计生
医疗技术和服务	卫生计生
血液管理	卫生计生
非法行医	卫生计生
卫生执法	卫生计生
医疗收费	卫生计生
其他	卫生计生
医疗机构管理	卫生计生
医务人员管理	卫生计生
律师	政法
法律援助	政法
司法鉴定	政法
公证	政法
其他	政法
法制宣传	政法
立法规划	政法
司法改革	政法
其他	政法
不服决定	政法
复议申请	政法
决定执行	政法
其他	政法
户籍管理	政法
出入境管理	政法
其他	政法
流动人口管理	政法
身份证管理	政法
交通事故	政法
其他	政法
机动车和驾驶员管理	政法
交通安全管理	政法
超期羁押	政法
警务执法	政法
其他	政法
刑讯逼供	政法
包庇违法违纪人员	政法
其他	政法
打黑除恶	政法
集会游行示威	政法
邪教组织	政法
黄赌毒	政法
防范打击恐怖活动	政法
拐卖人口	政法
治安案件	政法
走私贩私	政法
消防安全	政法
其他	政法
其他	政法
刑事诉讼	政法
民事诉讼	政法
行政诉讼	政法
立案侦查	政法
其他	政法
强制措施	政法
案件侦破	政法
其他	政法
监狱管理	政法
社区矫正	政法
生效法律文书执行	政法
其他	政法
司法调解	政法
人事仲裁	政法
劳动仲裁	政法
民商事仲裁	政法
企业教师	教育文体
师资力量	教育文体
原民办代课教师	教育文体
工资福利	教育文体
其他	教育文体
其他	教育文体
教育经费管理	教育文体
学生负担	教育文体
教学管理	教育文体
学历学位学籍管理	教育文体
校园安全	教育文体
民办学校	教育文体
语言文字规范	教育文体
校外机构管理	教育文体
其他	教育文体
收费标准	教育文体
乱收费	教育文体
教育统筹管理	教育文体
异地升学	教育文体
其他	教育文体
教育体制改革	教育文体
教育资源配置	教育文体
招生录取	教育文体
考场考纪	教育文体
其他	教育文体
异地升学	教育文体
其他	教育文体
其他	教育文体
教育救助	教育文体
希望工程	教育文体
其他	教育文体
体育事业	教育文体
运动员权益	教育文体
体育市场	教育文体
体育竞赛	教育文体
文化体制改革	教育文体
公共文化	教育文体
其他	教育文体
非物质文化遗产	教育文体
文化市场与文化执法	教育文体
文化艺术	教育文体
其他	教育文体
文物保护	教育文体
文物鉴定	教育文体
文物管理	教育文体
其他	劳动和社会保障
新农村合作医疗	劳动和社会保障
城乡居民养老保险	劳动和社会保障
城镇居民医疗保险	劳动和社会保障
职工养老保险	劳动和社会保障
职工工伤保险	劳动和社会保障
职工生育保险	劳动和社会保障
职工医疗保险	劳动和社会保障
职工失业保险	劳动和社会保障
其他	劳动和社会保障
福利待遇	劳动和社会保障
其他	劳动和社会保障
工资调整	劳动和社会保障
最低工资标准	劳动和社会保障
住房公积金	劳动和社会保障
工资发放	劳动和社会保障
其他	劳动和社会保障
就业和再就业	劳动和社会保障
职业培训	劳动和社会保障
职业技能鉴定	劳动和社会保障
其他	劳动和社会保障
工作时间和休息休假	劳动和社会保障
女工保护	劳动和社会保障
劳动安全	劳动和社会保障
劳动环境	劳动和社会保障
安全防护	劳动和社会保障
劳动合同纠纷	劳动和社会保障
非法用工	劳动和社会保障
其他	劳动和社会保障
农民工权益	劳动和社会保障
劳务派遣纠纷	劳动和社会保障
协议解除劳动关系	劳动和社会保障
辞职辞退	劳动和社会保障
其他	劳动和社会保障
社保基金管理	劳动和社会保障
其他	劳动和社会保障
退休人员待遇	劳动和社会保障
内部退养人员待遇	劳动和社会保障
其他	劳动和社会保障
退休政策	劳动和社会保障
退休金发放	劳动和社会保障
病退及提前退休人员待遇	劳动和社会保障